#   #  #   #    #   #     #    # # #   #
→ #  #   # # ##   # # ###   # #     ## #
####  # #  #   ###    #   #  #  # #    #
# # # #  ##  # #  ####  ## ### #  ## # #
#     # #   # #  #     ##      # #   # #
# # ###   ##    #  #####  ##### #  ##  #
# # #   ## # ## # ##     #      # #   ##
#  #  #  #   #  # #  # ##  # # #  # #  #
##  #  #   ##  ##  #  # # #   #  # #  ##
# #  #  ####  ## #  #     ### # #   #  #
#  # # #    #     # # # ##   #    # # ##
##   ##  ##  # # ##    #   # # # ## #  #
## ##   #   ###    ##### ###  ###   ## #
#  ### #  ## #  ###      #  #  #  ##   #
# # #  # #   # #    # #### # #  #  # # #
#     #  ## #  # # # #     #  # ##  #  #
#### ## #    # #  ##   # #  # #  # #  ##
#   #   ## # #  #   ###   #    # #  # ##
## #  ##   #  #  ##    ##  ## #  ## #  #
##   #  # #  ## #  ###   #  ##  #    # #
#  #### #  # #   # #  # ###   #  ## ## #
## # ##  # #   ##    #  ### # ## #    ##
#  #    ##  ###   # # #  #  #  #  # # ##
# # # #   # #   # #    # ##  # ##  ##  #
# #    # #   ###  # ## #   # #   #   # #
#  # #  #  #    # # # ####  ## # # # # #
# #   # # # ### ##     #  #   ##  #  # #
#  ## # # #       # ##  #  ##   #   #  #
## #  # #  # #### #   #   ## ## # # # ##
#   # ####  #   #  ##  ##     #  ## #  #
# # #   #  #  #  #   # #  # #  # #  ## #
##  # #   #  # # # # ### # ## #  ##  # #
#  ### # #  #  #  #      #   #  #  #   #
##  #   ## # #  # ### # #  # ##  # ## ##
# #   # #  #   #     #  # ##    #   #  @
#  # ## # # # #  ###  ##  # ## #  #  # #
##  #     #    ##   # ## #  # #  # # # #
###   ## #  ##    #       #     #      #
########################################